NO          ./textures/wall/front.xpm
SO      ./textures/wall/front.xpm
WE                  ./textures/wall/side.xpm
EA  ./textures/wall/side.xpm

F   42  ,       42,        42
C 42 ,   42     ,        42


1111111111111111111111
1X0100011X0X1100010X1
100100000000000001001
1D11000111D11100011D1
10000001X000X10000001
1110000D00N00D00001111
10000001X000X10000001
1D11000111D11100011D1
10010001XX0XX10001001
1X010001XXXXX100010X1
11111111111111111111111