NO ./textures/wall/front.xpm
SO ./textures/wall/front.xpm
WE ./textures/wall/side.xpm
EA ./textures/wall/side.xpm

F 150,75,0
C 135,206,235

11111111111111111111111111111111111111111111111
10000000000000000000000000000000000000000000001
10111111111111111111111111111111111111111111101
10100000000000000000000000000000000000000000101
10101111111111111111111111111111111111111110101
10101000000000000000000000000000000000000010101
10101011111111111111111111111111111111110110101
10101010000000000000000000000000000000010110101
10101010111111111111111111111111111110010110101
10101010100000000000000000000000000010010110101
10101010101111111111111111111111110010010110101
10101010101000000000000000000000010010010110101
10101010101011111111111111111110010010010110101
10101010101010000000000000000010010010010110101
10101010101010111111111111110010010010010110101
10101010101010100000000000010010010010010110101
10101010101010101111111110010010010010010110101
10101010101010101000000010010010010010010110101
10101010101010101011110010010010010010010110101
10101010101010101010010010010010010010010110101
10101010101010101010010010010010010010010110101
10101010101010101010010010010010010010010110101
10101010101010101010010010010010010010010110101
10101010101010101010010010010010010010010110101
10101010101010101010010010010010010010010110101
10101010101010101010010010010010010010010110101
10101010101010101010010010010010010010010110101
10101010101010101010010010010010010010010110101
10101010101010101010010010010010010010010110101
10101010101010101010010010010010010010010110101
10101010101010101010010010010010010010010110101
10101010101010101010010010010010010010010110101
10101010101010101010010010010010010010010110101
10101010101010101010010010010010010010010110101
10101010101010101010010010010010010010010110101
10101010101010101010010010010010010010010110101
10101010101010101010010010010010010010010110101
10101010101010101010010010010010010010010110101
10101010101010101010010010010010010010010110101
10101010101010101010010010010010010010010110101
10101010101010101010010010010010010010010110101
10101010101010101010010010010010010010010110101
10101010101010101010010010010010010010010110101
10101010101010101010010010010010010010010110101
10101010101010101010010010010010010010010110101
10101010101010101010010010010010010010010110101
10101010101010101010010010010010010010010110101
10101010101010101010010010010010010010010110101
10101010101010101010010010010010010010S10110101
10101010101010101010010010010010010010010110101
11111111111111111111111111111111111111111111111