NO ./textures/wall.xpm
SO ./textures/wall.xpm
WE ./textures/wall.xpm
EA ./textures/door.xpm

F 160,82,45
C 70,130,180

11111111111111111111111111111111111111111
10000000000000000000000000000000000000001
10000111111111111111111111111111110000001
10000100000000000000000000000000010000001
10000100000000000000000000000000010000001
10000100000111111111111111000000010000001
10000100000100000000000001000000010000001
10000100000100000000000001000000010000001
10000100000100000S00000001000000010000001
10000100000100000000000001000000010000001
10000100000100000000000001000000010000001
10000100000111111111111111000000010000001
10000100000000000000000000000000010000001
10000100000000000000000000000000010000001
10000111111111111111111111111111110000001
10000000000000000000000000000000000000001
11111111111111111111111111111111111111111
