NO ./textures/wall/front.xpm
SO ./textures/wall/front.xpm
WE ./textures/wall/side.xpm
EA ./textures/wall/side.xpm

F 0,255,0
C 0,0,255

111111111111111111111111111111111111111111111111111111111111111111111111111111111111111111111111
100000000000000000000000000000000000000000000000000000000000000000000000000000000000000000000001
100000000000000000000000000000000000000000000000000000000000000000000000000000000000000000000001
100000000000000000000000000000000000000000000000000000000000000000000000000000000000000000000001
100000000000000000000000000000000000000000000000000000000000000000000000000000000000000000000001
100111111111111111111111111111111111111111111111111111111111111111111111111111111111111111111001
100111111111111111111111111111111111111111111111111111111111111111111111111111111111111111111001
100111111111111111111111111111111111111111111111111111111111111111111111111111111111111111111001
100111111111111111111111111111111111111111111111111111111111111111111111111111111111111111111001
100111111111111111111111111111111111111111111111111111111111111111111111111111111111111111111001
100111111111111111111111111111111111111111111111111111111111111111111111111111111111111111111001
100111111111111111111111111111111111111111111111111111111111111111111111111111111111111111111001
100111111111111111111111111111111111111111111111111111111111111111111111111111111111111111111001
100111111111111111111111111111111111111111111111111111111111111111111111111111111111111111111001
100111111111111111111111111111111111111111111111111111111111111111111111111111111111111111111001
100111111111111111111111111111111111111111111111111111111111111111111111111111111111111111111001
100111111111111111111111111111111111111111111111111111111111111111111111111111111111111111111001
100111111111111111111111111111111111111111111111111111111111111111111111111111111111111111111001
100111111111111111111111111111111111111111111111111111111111111111111111111111111111111111111001
100111111111111111111111111111111111111111111111111111111111111111111111111111111111111111111001
100111111111111111111111111111111111111111111111111111111111111111111111111111111111111111111001
100111111111111111111111111111111111111111111111111111111111111111111111111111111111111111111001
100111111111111111111111111111111111111111111111111111111111111111111111111111111111111111111001
100111111111111111111111111111111111111111111111111111111111111111111111111111111111111111111001
100111111111111111111111111111111111111111111111111111111111111111111111111111111111111111111001
100111111111111111111111111111111111111111111111111111111111111111111111111111111111111111111001
100111111111111111111111111111111111111111111111111111111111111111111111111111111111111111111001
100111111111111111111111111111111111111111111111111111111111111111111111111111111111111111111001
100111111111111111111111111111111111111111111111111111111111111111111111111111111111111111111001
100111111111111111111111111111111111111111111111111111111111111111111111111111111111111111111001
100111111111111111111111111111111111111111111111111111111111111111111111111111111111111111111001
100111111111111111111111111111111111111111111111111111111111111111111111111111111111111111111001
100111111111111111111111111111111111111111111111111111111111111111111111111111111111111111111001
100111111111111111111111111111111111111111111111111111111111111111111111111111111111111111111001
100111111111111111111111111111111111111111111111111111111111111111111111111111111111111111111001
100111111111111111111111111111111111111111111111111111111111111111111111111111111111111111111001
100111111111111111111111111111111111111111111111111111111111111111111111111111111111111111111001
100111111111111111111111111111111111111111111111111111111111111111111111111111111111111111111001
100111111111111111111111111111111111111111111111111111111111111111111111111111111111111111111001
100111111111111111111111111111111111111111111111111111111111111111111111111111111111111111111001
100111111111111111111111111111111111111111111111111111111111111111111111111111111111111111111001
100111111111111111111111111111111111111111111111111111111111111111111111111111111111111111111001
100111111111111111111111111111111111111111111111111111111111111111111111111111111111111111111001
100111111111111111111111111111111111111111111111111111111111111111111111111111111111111111111001
100111111111111111111111111111111111111111111111111111111111111111111111111111111111111111111001
100111111111111111111111111111111111111111111111111111111111111111111111111111111111111111111001
100111111111111111111111111111111111111111111111111111111111111111111111111111111111111111111001
100111111111111111111111111111111111111111111111111111111111111111111111111111111111111111111001
100111111111111111111111111111111111111111111111111111111111111111111111111111111111111111111001
100111111111111111111111111111111111111111111111111111111111111111111111111111111111111111111001
100111111111111111111111111111111111111111111111111111111111111111111111111111111111111111111001
100111111111111111111111111111111111111111111111111111111111111111111111111111111111111111111001
100111111111111111111111111111111111111111111111111111111111111111111111111111111111111111111001
100111111111111111111111111111111111111111111111111111111111111111111111111111111111111111111001
100111111111111111111111111111111111111111111111111111111111111111111111111111111111111111111001
100111111111111111111111111111111111111111111111111111111111111111111111111111111111111111111001
100111111111111111111111111111111111111111111111111111111111111111111111111111111111111111111001
100111111111111111111111111111111111111111111111111111111111111111111111111111111111111111111001
100111111111111111111111111111111111111111111111111111111111111111111111111111111111111111111001
100111111111111111111111111111111111111111111111111111111111111111111111111111111111111111111001
100111111111111111111111111111111111111111111111111111111111111111111111111111111111111111111001
100111111111111111111111111111111111111111111111111111111111111111111111111111111111111111111001
100111111111111111111111111111111111111111111111111111111111111111111111111111111111111111111001
100111111111111111111111111111111111111111111111111111111111111111111111111111111111111111111001
100111111111111111111111111111111111111111111111111111111111111111111111111111111111111111111001
100111111111111111111111111111111111111111111111111111111111111111111111111111111111111111111001
100111111111111111111111111111111111111111111111111111111111111111111111111111111111111111111001
100111111111111111111111111111111111111111111111111111111111111111111111111111111111111111111001
100111111111111111111111111111111111111111111111111111111111111111111111111111111111111111111001
100111111111111111111111111111111111111111111111111111111111111111111111111111111111111111111001
100111111111111111111111111111111111111111111111111111111111111111111111111111111111111111111001
100111111111111111111111111111111111111111111111111111111111111111111111111111111111111111111001
100111111111111111111111111111111111111111111111111111111111111111111111111111111111111111111001
100111111111111111111111111111111111111111111111111111111111111111111111111111111111111111111001
100111111111111111111111111111111111111111111111111111111111111111111111111111111111111111111001
100111111111111111111111111111111111111111111111111111111111111111111111111111111111111111111001
100111111111111111111111111111111111111111111111111111111111111111111111111111111111111111111001
100111111111111111111111111111111111111111111111111111111111111111111111111111111111111111111001
100111111111111111111111111111111111111111111111111111111111111111111111111111111111111111111001
100111111111111111111111111111111111111111111111111111111111111111111111111111111111111111111001
100111111111111111111111111111111111111111111111111111111111111111111111111111111111111111111001
100111111111111111111111111111111111111111111111111111111111111111111111111111111111111111111001
100111111111111111111111111111111111111111111111111111111111111111111111111111111111111111111001
100111111111111111111111111111111111111111111111111111111111111111111111111111111111111111111001
100111111111111111111111111111111111111111111111111111111111111111111111111111111111111111111001
100111111111111111111111111111111111111111111111111111111111111111111111111111111111111111111001
100111111111111111111111111111111111111111111111111111111111111111111111111111111111111111111001
100111111111111111111111111111111111111111111111111111111111111111111111111111111111111111111001
100111111111111111111111111111111111111111111111111111111111111111111111111111111111111111111001
100111111111111111111111111111111111111111111111111111111111111111111111111111111111111111111001
100111111111111111111111111111111111111111111111111111111111111111111111111111111111111111111001
100111111111111111111111111111111111111111111111111111111111111111111111111111111111111111111001
100111111111111111111111111111111111111111111111111111111111111111111111111111111111111111111001
100111111111111111111111111111111111111111111111111111111111111111111111111111111111111111111001
100111111111111111111111111111111111111111111111111111111111111111111111111111111111111111111001
100111111111111111111111111111111111111111111111111111111111111111111111111111111111111111111001
100111111111111111111111111111111111111111111111111111111111111111111111111111111111111111111001
100111111111111111111111111111111111111111111111111111111111111111111111111111111111111111111001
100111111111111111111111111111111111111111111111111111111111111111111111111111111111111111111001
100111111111111111111111111111111111111111111111111111111111111111111111111111111111111111111001
100111111111111111111111111111111111111111111111111111111111111111111111111111111111111111111001
100111111111111111111111111111111111111111111111111111111111111111111111111111111111111111111001
100111111111111111111111111111111111111111111111111111111111111111111111111111111111111111111001
100111111111111111111111111111111111111111111111111111111111111111111111111111111111111111111001
10000000000000000000000000000000000000000000000000000000000000000000000000000000000000000000E001
100000000000000000000000000000000000000000000000000000000000000000000000000000000000000000000001
100000000000000000000000000000000000000000000000000000000000000000000000000000000000000000000001
100000000000000000000000000000000000000000000000000000000000000000000000000000000000000000000001
100000000000000000000000000000000000000000000000000000000000000000000000000000000000000000000001
111111111111111111111111111111111111111111111111111111111111111111111111111111111111111111111111