NO ./textures/wall.xpm
SO ./textures/wall.xpm
WE ./textures/wall.xpm
EA ./textures/door.xpm

F 100,50,0
C 0,50,100

111111111111111
100000000000001
100111111110001
100100000010001
100101W10010001
100100000010001
100111111110001
100000000000001
111111111111111
