NO ./textures/wall/front.xpm
SO ./textures/wall/front.xpm
WE ./textures/wall/side.xpm
EA ./textures/wall/side.xpm

F 255,204,0
C 102,51,153

111111111111111111111111111111111111111111111111
100000000000000000000000000000000000000000000001
101111111111111111111111111111111111111111111101
100000000000000000000000000000000000000000000001
101111111111111111111111111111111111111111111101
100000000000000000000000000000000000000000000001
101111111111111111111111111111111111111111111101
100000000000000000000000000000000000000000000001
101111111111111111111111111111111111111111111101
100000000000000000000000000000000000000000000001
101111111111111111111111111111111111111111111101
100000000000000000000000000000000000000000000001
101111111111111111111111111111111111111111111101
100000000000000000000000000000000000000000000001
101111111111111111111111111111111111111111111101
100000000000000000000000000000000000000000000001
101111111111111111111111111111111111111111111101
100000000000000000000000000000000000000000000001
101111111111111111111111111111111111111111111101
100000000000000000000000000000000000000000000001
101111111111111111111111111111111111111111111101
100000000000000000000000000000000000000000000001
101111111111111111111111111111111111111111111101
100000000000000000000000000000000000000000000001
101111111111111111111111111111111111111111111101
100000000000000000000000000000000000000000000001
101111111111111111111111111111111111111111111101
100000000000000000000000000000000000000000000001
101111111111111111111111111111111111111111111101
100000000000000000000000000000000000000000000001
101111111111111111111111111111111111111111111101
100000000000000000000000000000000000000000000001
101111111111111111111111111111111111111111111101
100000000000000000000000000000000000000000000001
101111111111111111111111111111111111111111111101
100000000000000000000000000000000000000000000001
101111111111111111111111111111111111111111111101
100000000000000000000000000000000000000000000001
101111111111111111111111111111111111111111111101
100000000000000000000000000000000000000000000001
101111111111111111111111111111111111111111111101
100000000000000000000000000000000000000000000001
101111111111111111111111111111111111111111111101
100000000000000000000000000000000000000000000001
101111111111111111111111111111111111111111111101
100000000000000000000000000000000000000000000001
101111111111111111111111111111111111111111111101
100000000000000000000000000000000000000000000001
101111111111111111111111111111111111111111111101
100000000000000000000000000000000000000000000001
10111111111111111111111111W11111111111111111101
100000000000000000000000000000000000000000000001
111111111111111111111111111111111111111111111111