NO   	 	 	 	 	 	./textures/wall/front.xpm
			F 100,1,200					
SO 										./textures/wall/front.xpm
																				EA ./textures/wall/side.xpm

C 										 	 50,100,150 
WE ./textures/wall/side.xpm

1111111111111
1000000000001
1000111000001
1000101000001
1000101000001
1000101000001
1000111000001
1000000000001
1000000E00001
1111111111111