NO ./textures/wall_front.xpm
SO ./textures/wall_front.xpm
WE ./textures/wall_side.xpm
EA ./textures/wall_side.xpm

F 128,128,128
C 89,89,89

        1111111111111111111111111111111111
        100000000011000000000000000000N001
        1011000001110000000000000000000001
        1001000000000000000000000000000001
111111111011000001110000000000000000000001
10000000001100000111D111111111D11111111111
11110111111D11101111011111111101111111111
11110110111D11101111011111000000000000001
11000000110000001111011111011111111111111
10000000000000001100000111011111111111111
10000110000001101101010111011111111111111
11000111011101101111000000011111111111111
11110111011101101111101111111111111111111
11111111011101101111111111111111111111111
        1111111111111111111111111111111111