NO ./textures/wall_front.xpm
SO ./textures/wall_front.xpm
WE ./textures/wall_side.xpm
EA ./textures/wall_side.xpm

F 42,46,48
C 32,35,37

111111111111111111111111
100001         100000001
10X001111111111100000001
1000000000X0000W00000001
1000000D0000000000000001
111111111111111111111111