NO ./textures/wall/front.xpm
SO ./textures/wall/front.xpm
WE ./textures/wall/side.xpm
EA ./textures/wall/side.xpm

F 42,42,42
C 42,42,42

1111111111111111111111111111111111111111111111111111
1111111111111111111111111111111111111111111010000111
1000000001100000000000000000000000000000011000100101
1011111101100000000000000000000000000000011011110001
1010X10001100100010011111001111100111110011010X11101
1010000001100100010010001000010000100010011010010101
1011111111100111110000111000010000111110011010010101
101000000110000001001100000001000010010001101011D101
1011111101100000010011111000010000100010011010000101
101X0000011000000000000000000000000000000110111D1101
1011101111100000000000000000000000000000011000100001
1000000001111111111111111111111111111111111000100001
11111111D1111111111111111111111111111111111101111111
1000000101X000000000000000000000000001000000D0000001
1011110101X00000111111111111111111110101111101001001
101X000101111100100000000000000000010101000101110001
1011111101111100101111111111111111010101010101011111
1000000000000000101000000000000001010101010101000001
1111111D11111111101111111D111111110101011101D1111101
10000100001X0010000000000000000001000000000000000001
101X111010101010X00000000000000001111111111111111101
1011101010101010000000000000000001000000000100000101
101000101X001010111111111D11111111011111110101111101
1X1011101110101010000100000001000001X0X0X10101000001
10100000000000101000010D000X010111110111010101011101
1X111110111110101D1111000000010100X1X0X1X10101010101
101000000000100000000D000S000D0101111111010101010101
1011011111101111101111000000010100000000010101010101
10010000000000D0101XX101000D010101111111110101010111
1001010011111110101001000000010000000000000000010001
1000011010000000101001111D1111011111111111111111D101
111111001011111110100D001000000000000000000000100101
1000010110D0X100101111101011100111101011111110100101
11110100101X0100100001001000000001001001000000111111
100001101011111010100D001011111101011101101100000001
11010000101010101011111110101X0101XX1001001001110101
10011111111010101000000000101X0101001111111111010101
1000000000001010101111000010110101010000000010010101
111111D111101010100001011110000101011111111011110101
1000010010001010111101000000110100000001X000000001X1
10110100101110100000011111111101111111D11111110101X1
1010010010000011111100000000010100010101010000011111
1011110010111010100000000001010101010101011101110001
1000000010101010101D11111111010101010101010000000101
1111110110101010101010000001010001010111010111111101
101001000010100000101X11110101111101000D000100001001
1X100001111010111110101X0101000001011111111111101111
1X111101000010100010111101010001010000100000001010X1
1X10000101111011101011000101111101111110101111101001
1X101101010000100010000101000001000000001X100000D0X1
1X10110101111110111111110101111111110111111011111001
10D00000000000000000000000000000000100000000000010X1
1111111111111111111111111111111111111111111111111111