NO ./textures/wall_front.xpm
SO ./textures/wall_front.xpm
WE ./textures/wall_side.xpm
EA ./textures/wall_side.xpm

F 128,128,128
C 89,89,89

            1111111111111111111111111111111111
            100W100000000000000000000000000001
            101111111100000000000000000000001
            1010000001000000000000000000000001
1111111111111010111101000000000000000000000001
1010100001000000000000000000000001111111111111
1010111111000000000000000000000001
1010100000000000000000000000000001
1000111111111111110000000000000001
1000000001000001000000000000000001
1111111011010000000000000000000001
1000001010011011111110000000000001
1001111011110001000000000000000001
1000000000000000000000000000000001
1111111111111111111111111111111111