NO ./textures/wall.xpm
SO ./textures/wall.xpm
WE ./textures/wall.xpm
EA ./textures/wall.xpm

F 220,100,0
C 225,30,0

1111111111111111111111111111111111
100S100000000000000000000000000001
101111111100000000000000000000001
1010000001000000000000000000000001
1010111101000000000000000000000001
1010100001000000000000000000000001
1010111111000000000000000000000001
1010100000000000000000000000000001
1000111111111111110000000000000001
1000000001000001000000000000000001
1111111011010000000000000000000001
1000001010011011111110000000000001
1001111011110001000000000000000001
1000000000000000000000000000000001
1111111111111111111111111111111111