NO ./textures/wall/front.xpm
SO ./textures/wall/front.xpm
WE ./textures/wall/side.xpm
EA ./textures/wall/side.xpm

F 255, 69,0
C 30,144,255

11111111111111111
1010000D0000X0001
101011111D1111101
10000X0010000X1N1
11111111111111111