NO ./textures/coin_0.xpm



                                                    SO ./textures/coin_0.xpm

C 89,89,89


WE ./textures/coin_0.xpm




EA ./textures/coin_0.xpm

















F 42,42,42

11111111111111111
1010000D0000X0001
101011111D1111101
10000X0010000X1N1
11111111111111111