NO ./textures/wall/front.xpm
SO ./textures/wall/front.xpm
WE ./textures/wall/side.xpm
EA ./textures/wall/side.xpm

F 151,51,2
C 9,35,13

111111
100001
11S001
111111

111
101
111
