NO ./textures/wall/front.xpm
SO ./textures/wall/front.xpm
WE ./textures/wall/side.xpm
EA ./textures/wall/side.xpm

F 220,100,0
C 225,30,0

111111111111111111111111
100000000011000000000000
101100000111000000000000
100100000000000000000000
100000000011000001110000
100000000011000001110111
111101111111110111000000
111101111111110111010100
110000001101010111000000
100000000000000011000000
100000000000000011010100
110000001101010111110111
11110111111101111111N11
111111111111111111111111