NO ./textures/wall_front.xpm
SO ./textures/wall_front.xpm
WE ./textures/wall_side.xpm
EA ./textures/wall_side.xpm

F 220,100,0
C 225,30,0

111111
100001
102001
100001
111111
