NO ./textures/wall/front.xpm
SO ./textures/wall/front.xpm
WE ./textures/wall/side.xpm
EA ./textures/wall/side.xpm

F 220,100,0
C 225,30,0

1111111111111111111111111
1000000000110000000000001
111000001110000000000001
101000000000000000000001
 00000000110000011100001
1000000000110000000101111
1111011111111101110000001
1111011111111101110101001
1100000011010101110000001
1000000000100000110000001
1000000000000000110101001
1100000011010101111101111
111101111111011111111N111
111111111111111111111111
