NO ./textures/wall/front.xpm
SO ./textures/wall/front.xpm
WE ./textures/wall/side.xpm
EA ./textures/wall/side.xpm

F 255,69,0
C 30,144,255

11111111111111
10000000000001
1DDDDDDDDDDDD1
100000D0000001
100000D0000001
100000D000N001
100000D0000001
100000D0000001
11111111111111