NO ./textures/wall/front.xpm
SO ./textures/wall/front.xpm
WE ./textures/wall/side.xpm
EA ./textures/wall/side.xpm

F 255,215,0
C 25,25,112

111111111111111111111111111111111111111111111111
100000000000000000000000000000000000000000000001
10X00000X00000X00000X00000X00000X00000X00000X01
100000000000000000000000000000000000000000000001
100000000000000000000000000000000000000000000001
10X00000X00000X00000X00000X00000X00000X00000X01
100000000000000000000000000000000000000000000001
100000000000000000000000000000000000000000000001
10X00000X00000X00000X00000X00000X00000X00000X01
100000000000000000000000000000000000000000000001
100000000000000000000000000000000000000000000001
10X00000X00000X00000X00000X00000X00000X00000X01
100000000000000000000000000000000000000000000001
100000000000000000000000000000000000000000000001
10X00000X00000X00000X00000X00000X00000X00000X01
100000000000000000000000000000000000000000000001
100000000000000000000000000000000000000000000001
10X00000X00000X00000X00000X00000X00000X00000X01
100000000000000000000000000000000000000000000001
100000000000000000000000000000000000000000000001
10X00000X00000X00000X00000X00000X00000X00000X01
100000000000000000000000000000000000000000000001
100000000000000000000000000000000000000000000001
10X00000X00000X00000X00000X00000X00000X00000X01
100000000000000000000000000000000000000000000001
100000000000000000000000000000000000000000000001
10X00000X00000X00000X00000X00000X00000X00000X01
100000000000000000000000000000000000000000000001
100000000000000000000000000000000000000000000001
10X00000X00000X00000X00000X00000X00000X00000X01
100000000000000000000000000000000000000000000001
100000000000000000000000000000000000000000000001
10X00000X00000X00000X00000X00000X00000X00000X01
100000000000000000000000000000000000000000000001
100000000000000000000000000000000000000000000001
10X00000X00000X00000X00000X00000X00000X00000X01
100000000000000000000000000000000000000000000001
100000000000000000000000000000000000000000000001
10X00000X00000X00000X00000X00000X00000X00000X01
100000000000000000000000000000000000000000000001
100000000000000000000000000000000000000000000001
10X00000X00000X00000X00000X00000X00000X00000X01
100000000000000000000000000000000000000000000001
100000000000000000000000000000000000000000000001
10X00000X00000X00000X00000X00000X00000X00000X01
100000000000000000000000000000000000000000000001
100000000000000000000000000000000000000000000001
10000000000000000000S00000000000000000000000011
111111111111111111111111111111111111111111111111